10 10
6 4
1 1
9 1
1 9
9 9
0 0 0 0 0 0 0 0 0 0
0 2 1 1 1 1 1 1 2 0
0 0 0 1 0 0 0 0 1 0
0 0 0 1 1 1 1 1 1 0
0 0 0 1 0 1 0 0 1 0
3 1 1 1 0 1 0 0 1 3
0 0 0 1 1 1 1 1 1 0
0 0 0 1 0 0 0 0 1 0
0 2 1 1 1 1 1 1 2 0
0 0 0 0 0 0 0 0 0 0
mapagolge.png
