10 10
5 3
1 1
8 1
1 8
8 8
0 0 0 0 0 0 0 0 0 0
0 2 1 1 1 1 1 1 2 0
0 0 0 1 0 0 0 0 1 0
0 0 0 1 1 1 1 1 1 0
0 0 0 1 0 1 0 0 1 0
3 1 1 1 0 1 0 0 1 3
0 0 0 1 1 1 1 1 1 0
0 0 0 1 0 0 0 0 1 0
0 2 1 1 1 1 1 1 2 0
0 0 0 0 0 0 0 0 0 0
mapagolge.png
